11111111
10000001
1000T001
10000001
10P00001
10000001
10000001
11111111