111111111111111111111111
100000000000000000000001
100000000000000000000001
100000000001100000000001
111110000000001111100001
111110000000001111100001
111110000000001110000001
111110000000001110000001
100000000000000000000001
100000000000000000000011
100000000000000000011111
100000000111100000000001
110000000000100000000001
110000000000000000000001
110000000000000000000001
1000000000000000P0000001
100000000000000000000001
100000000000000000000001
100000000000000000000001
111111111111111111111111