11111111111111111
10000000000000001
10000P00000000001
10000000000000001
10000000000000001
10000000000000001
10000000000000001
10000000000000001
10000000000000001
10000000000000001
100T0000T0000T001
10000000000000001
10000000000000001
11111111111111111